ALL WORDS

leksetis (f): defense, protection
Ministerjom Enterōm Θetīōm SPA (n): United States Department of the Interior
Ministerjom Dīksas SPA (n): United States Department of Justice
Ministerjom Leksetīs SPA (n): United States Department of Defense
Ministerjom Φinantsōm SPA (n): United States Department of the Treasury
φinantsa (f): finances (in plural)
Ministerjom Eksterōm Θetīōm SPA: United States Department of State
ministerjom (n): ministry
ministēr (m): minister
djagnōsis (f): diagnosis
djagnōstiskos (adj): diagnostic
djagnōstīo (v): to diagnose
eksteros (adj): external
enteros (adj): internal
antis (f): front
anti (adv): forward
nerodos (adj): incorrect, not correct, not right; not straight, not right
a (n): letter a
be (n): letter b
Alabāma (f): Alabama
Aljāska (f): Alaska
Arisōna (f): Arizona
Arkānsa (f): Arkansas
Kaliφornīa (f): California
Kolorādo (m): Colorado
Konnektikut (m): Connecticut
Delawer (m): Delaware
Φlorida (f): Florida
Jorja (f): Georgia
Awāj (m): Hawaii
Ajdao (m): Idaho
Illinōj (m): Illinois
Indjāna (f): Indiana
Ajowa (f): Iowa
Kansa (f): Kansas
Kentaki (f): Kentucky
Lūisjāna (f): Louisiana
Mejn (f): Maine
Mariland (f): Maryland
Massatsjūset (m): Massachusetts
Mitsigan (m): Michigan
Minnesōta (f): Minnesota
Mississīpi (f): Mississippi
Missūri (f): Missouri
Montāna (f): Montana
Nebrāska (f): Nebraska
Newāda (f): Nevada
Nūa Ampsjer (f): New Hampshire
Nūos Mesiko (m): New Mexico
Oniska Karolīna (f): North Carolina
Oniska Dakōta (f): North Dakota
Oājo (m): Ohio
Oklaōma (f): Oklahoma
Oregon (m): Oregon
Pensilwanīa (f): Pennsylvania
Rod-Ajland (f): Rhode Island
Soniska Karolīna (f): South Carolina
Soniska Dakōta (f): South Dakota
Tennessī (f): Tennessee
Teksa (f): Texas
Juta (f): Utah
Wermōnt (m): Vermont
Wirginīa (f): Virginia
Wesiska Wirginīa (f): West Virginia
Wiskōnsin (m): Wisconsin
Wajōmin (m): Wyoming
Distriktos Kolumbīas (m): District of Columbia
Amerikiska Samoa (f): American Samoa
Gwam (m): Guam
Artobomos (m): (proper name) strong bear
Artoθorsos (m): (proper name) courageous bear
Artokretos (m): (proper name) clever bear
Artonēr (m): (proper name) powerful bear
Awsodonos (m): (proper name) gift of the dawn
Awsōs (f): (proper name) dawn
Bomadotōr (m): (proper name) strong leader
Bomajos (m): (proper name) strong metal
Bomartos (m): (proper name) strong bear
Bomaspēs (m): (proper name) prosperous strong
Bomistadotōr (m): (proper name) strongest leader
Bomistokretos (m): (proper name) strongest clever
Bomistonēr (m): (proper name) strongest powerful
Bomonēr (m): (proper name) strong powerful
Bomorōn (m): (proper name) strong eagle
Bomowalpos (m): (proper name) strong wolf
Bomowīk (m): (proper name) strong victory
Denetwos (m): (proper name) horse tame
Detaspēs (m): (proper name) prosperous good
Detolūkos (m): (proper name) good light
Detorēdus (m): (proper name) good king, good ruler
Dīwodonos (m): (proper name) gift of god
Dīwoluφos (m): (proper name) lover of god
Djudonos (m): (proper name) gift of the sky
Djusθugatēr (f): (proper name) daughter of the sky
Djussūnus (m): (proper name) son of the sky
Donaspēs (m): (proper name) prosperous gift
Donodīwos (m): (proper name) gift of god
Dononēr (m): (proper name) powerful gift
Etwodenos (m): (proper name) horse tame
Etwodenotēr (m): (proper name) horse tamer
Θorsartos (m): (proper name) courageous bear
Θorsistartos (m): (proper name) most courageous bear
Θorsistobomos (m): (proper name) most courageous strong
Θorsistotawros (m): (proper name) most courageous bull
Θorsistowalpos (m): (proper name) most courageous wolf
Θorsonēr (m): (proper name) courageous powerful
Θorsotawros (m): (proper name) courageous bull
Θorsowalpos (m): (proper name) courageous wolf
Θugaterdjus (f): (proper name) daughter of the sky
Kretistonēr (m): (proper name) most clever powerful
Klūobomos (m): (proper name) fame strength
Klūonēr (m): (proper name) fame power
Klūos (m): (proper name) fame
Klūowīk (m): (proper name) famous victory
Leksajos (m): (proper name) metal protecter
Leksanēr (m): (proper name) powerful protecter
Leksatūtos (m): (proper name) protecter of the people
Leksaxeθomos (m): (proper name) protecter of the world
Leksorēdus (m): (proper name) metal ruler
Lūkos (m): (proper name) light
Lūφos (m): (proper name) love
Medartos (m): (proper name) big bear
Morunepōtus (m): (proper name) grandson of the sea
Moxartos (m): (proper name) able bear
Moxistartos (m): (proper name) most able bear
Moxistonēr (m): (proper name) most able powerful
Moxistorēdus (m): (proper name) most able ruler
Nerajos (m): (proper name) powerful metal
Nerammōn (m): (proper name) powerful stone
Nerartos (m): (proper name) powerful bear
Neraspēs (m): (proper name) powerful prosperous
Nerbomos (m): (proper name) strong powerful
Neristajos (m): (proper name) most powerful metal
Neristammōn (m): (proper name) most powerful stone
Neristartos (m): (proper name) most powerful bear
Neristobomos (m): (proper name) most powerful strong
Neristoθorsos (m): (proper name) most powerful courageous
Neristokretos (m): (proper name) most powerful intelligent
Neristotawros (m): (proper name) most powerful bull
Neristowalpos (m): (proper name) most powerful wolf
Neristoplūtos (m): (proper name) most powerful rich
Neristorēdus (m): (proper name) most powerful ruler
Nerleksos (m): (proper name) powerful protecter
Numa (f): (proper name) soul, spirit
Pima (f): (proper name) peace
Pimoner (m): (proper name) peace powerful
Plūtaspēs (m): (proper name) rich prosperity
Plūtonēr (m): (proper name) rich power
Rēdunēr (m): (proper name) powerful ruler
Sowandonos (m): (proper name) gift of the sun
Sūnudjus (m): (proper name) son of the sky
Swadimelita (f): (proper name) sweet honey
Tawrobomos (m): (proper name) strong bull
Tawroθorsos (m): (proper name) courageous bull
Tawronēr (m): (proper name) powerful bull
Torpīa (f): (proper name) happiness, joy
Walpobomos (m): (proper name) strong wolf
Walpoθorsos (m): (proper name) courageous wolf
Walponēr (m): (proper name) powerful wolf
Wīdonēr (m): (proper name) wise powerful
Wītastēr (m): (proper name) bright star
Wītawsōs (m): (proper name) bright dawn
Wītoφlota (f): (proper name) bright flower
Wītodīn (m): (proper name) bright day
Φīθetis (f): (proper name) faith
Xeθorrēdus (m): (proper name) ruler of the world
Abdīa (m): Abdiah, Abdias, Obadiah, Obadias
Abram (m): Abram
Abrāmos (m): Abraham
Aggajos (m): Haggai
Ādām (m): Adam
Adrjānos (m): Hadrian, Adrian
Ajkaterīna (f): Catherine
Ajlagos (m): Oleg (Holy, from Proto Germanic)
Ajlaga (f): Olga
Ajmarīk (m): Henry
Albertos (m): Albert
Aleksandros (m): Alexander
Ambakkūm (m): Habakkuk
Amōs (m): Amos
Andrēa (m): Andrew
Andrēa (f): Andrea
Anna (f): Anna
Antōnjos (m): Anthony
Ārōn (m): Aaron
Asteφanos (m): Stephen
Awgustos (m): Augustus, August
Barθolomajos (m): Bartholomew
Barūk (m): Barak, Baruch
Benjāmīn (m): Benjamin
Galīlajos (m): Galileo, Galilean, Galilaeus
Geōrgjos (m): George
Gīslabērtos (m): Gilbert
Grēgorjos (m): Greg, Gregory
Gundisālwos (m): Gonzalo
Dānīēl (m): Daniel
Dawīd (m): David
Dēmētrjos (m): Demeter, Dmitri
Djāna (f): Diana
Ēdgār (m): Edgar, Edgardo
Elēna (f): Helena
Ēlīa (m): Elijah
Elisabeta (f): Elizabeth, Isabel
Ernustos (m): Ernest, Ernesto
Ēsaīa (m): Isaiah
Esdra (m): Ezra, Esdras
Esθēr (f): Esther
Ēwa (f): Eve
Θeodōros (m): Theodore
Θōma (m): Thomas
Immanūēl (m): Immanuel
Isāk (m): Isaac
Ismāēl (m): Ismael
Jakōbos (m): Jacob, James, Jack, Jacques
Jeremīa (m): Jeremy, Jeremias, Jeremiah
Jesekīēl (m): Ezekiel
Jēsus (m): Jesus, Joshua
Jōānna (m): John, Juan, Jean
Jōānna (f): Juana, Jane
Jōb (m): Job
Jōēl (m): Joel
Jōna (m): Jonah, Jonas
Jōsēφos (m): Joseph
Jūda (m): Judas
Jūdīt (f): Judith
Jūljos (m): Julius, July
Jūlja (f): Julia
Kajsār (m): Caesar
Karolos (m): Charles
Kūrillos (m): Cyril, Cyrillus, Kirill
Leōnartos (m): Leonhard, Leonardo, Leonard
Lewi (m): Levi
Lūdawīg (m): Louis, Lewis, Ludwig, Clovis
Lūka (m): Luke
Malaxīa (m): Malachi, Malachias
Manāssis (m): Manasseh, Manasses
Marīa (f): Mary
Mārkos (m): Mark
Matθājos (m): Matthew
Mixāēl (m): Michael
Mixaīa (m): Micah, Micas, Michaiah, Michaias
Mōsis (m): Moses
Naθanāēl (m): Nathanael
Nāūm (m): Nahum, Naoum
Nēmīa (m): Nehemiah, Nehemias
Nīkola (m): Nicholas
Nīkolāos (m): Nicholas
Olīwa (f): Olivia
Ōsēa (m): Hosea
Pawlos (m): Paul
Petros (m): Peter
Rāφāēl (m): Raphael
Rēdūlφos (m): Ralph, Raúl
Rīxārdos (m): Richard
Rōbertos (m): Robert
Rōθirīk (m): Rodrigo, Rurik
Rōθjūlφos (m): Rudolph, Rodolph
Rosa (f): Rosa, Rose
Rūt (f): Ruth
Samūēl (m): Samuel
Sawēr (m): Javier
Sawlos (m): Saul
Saxarīa (m): Zacharias, Zechariah, Zachariah
Sergjos (m): Sergius, Sergei
Simōn (m): Simon
Sira (m): Sirach, Sira
Soφīa (f): Sophia
Soφonīa (m): Sophonias, Zephaniah
Tīmoθeos (m): Timothy
Titos (m): Titus
Tobīa (m): Tobias
Waldimiros (m): Vladimir
Waldislawos (m): Vladislav
Wiktōr (m): Victor
Wiljēlmos (m): William, Guillermo, Wilhelm
Φawstos (m): Faustus
Φilēmōn (m): Philemon
Φilippos (m): Philip, Felipe
Φriθurīk (m): Federico, Fredrick, Friedrich
Xristjānos (m): Christian
ge (n): letter g
de (n): letter d
e (n): letter e
θe (n): letter θ
i (n): letter i
ja (n): letter j
ka (n): letter k
el (n): letter l
em (n): letter m
en (n): letter n
o (n): letter o
pe (n): letter p
er (n): letter r
es (n): letter s
te (n): letter t
u (n): letter u
φe (n): letter φ
xa (n): letter x
witwos (pn): whole (singular), all (plural)
witwopos (pn): each
udrogenom (n): hydrogen
ojnos (num): one
dūo (num): two
trīes (num): three
petwōres (num): four
pempe (num): five
sweks (num): six
septam (num): seven
okto (num): eight
newam (num): nine
dekam (num): ten
ojnodant (num): eleven
dwidant (num): twelve
tridant (num): thirteen
peturdant (num): fifteen
swesdant (num): sixteen
septandant (num): seventeen
oktodant (num): eighteen
newandant (num): nineteen
dwitont (num): twenty
tritont (num): thirty
peturtont (num): forty
pempetont (num): fifty
wesbont (num): sixty
septantont (num): seventy
oktantont (num): eighty
newantont (num): ninety
kantom (num): hundred
tustont (num): myriad
protos (num): first
witeros (num): second
tretos (num): third
peturos (num): fourth
pentos (num): fifth
sektos (num): sixth
sentos (num): seventh
oktos (num): eighth
newnos (num): ninth
dentos (num): tenth
ojnodantos (num): eleventh
dwidantos (num): twelfth
tridantos (num): thirteenth
peturdantos (num): fourteenth
pempedantos (num): fifteenth
swesdantos (num): sixteenth
septandantos (num): seventeenth
oktodantos (num): eighteenth
newandantos (num): nineteenth
dwitontos (num): twentieth
tritontos (num): thirtieth
peturtontos (num): fortieth
pempetontos (num): fiftieth
wesbontos (num): sixtieth
septantontos (num): seventieth
oktantontos (num): eightieth
newantontos (num): ninetieth
kantomos (num): hundredth
tustontos (num): myriadth
sam (num): once
dwis (num): twice
tris (num): thrice
petris (num): four times
pentis (num): five times
sektis (num): six times
sampeltos (adj): single
dwispeltos (adj): double
trispeltos (adj): triple
ēljom (n): helium
Angliska (f): English language
Danetiska (f): Danetian language
Φrankiska (f): French language
Germaniska (f): German language
Rossiska (f): Russian language
Ispaniska (f): Spanish language
Italiska (f): Italian language
Grajkiska (f): Greek language
Arabiska (f): Arabic language
Siniska (f): Chinese language
Mongoliska (f): Mongolian language
Japoniska (f): Japanese languge
Serbiska (f): Serbian language
liθjom (n): lithium
bērulljom (n): beryllium
borom (n): boron
karbōn (m): carbon
nitrogenom (n): nitrogen
oksugenom (n): oxygen
φlūōr (m): fluorine
neom (n): neon
natrjom (n): sodium
magnēsjom (n): magnesium
aluminjom (n): aluminium, aluminum
silikōn (m): silicon
φōsφoros (m): phosphorus
sulφōr (m): sulfur
xlōrom (n): chlorine
ārgom (n): argon
kaljom (n): potassium
kalkjom (n): calcium
askandjom (n): scandium
tītānjom (n): titanium
jōdom (n): iodine
natrjosjo xlōridom (n): sodium chloride
natrjosjo φlūoridom (n): sodium fluoride
udroxlōriskom surinom (n): hydrochloric acid
nitriskom surinom (n): nitric acid
udrojōdiskom surinom (n): hydroiodic acid
perxlōriskom surinom (n): perchloric acid
xlōriskom surinom (n): chloric acid
surinom (n): acid
meos (pn): mine
tūos (pn): yours
sūos (pn): his
nosjos (pn): ours
wosjos (pn): y’all’s
swosjos (pn): theirs
posjos (pn): whose
pote (adv): where
podo (adv): when
posom (adv): how
pople (adv): how much, how many
pospe (adv): why
tote (adv): there
todo (adv): then
tosom (adv): like that
tople (adv): that many, that much
tospe (adv): because of that, due to that
witwote (adv): everywhere
witwodo (adv): everywhen
witwosom (adv): in every manner
witwople (adv): every many
witwospe (adv): due to everything
newitwote (adv): somewhere
newitwodo (adv): some time
newitwosom (adv): in some way
newitwople (adv): some amount
newitwospe (adv): some reason
nete (adv): nowhere
nedo (adv): never
nesom (adv): in no manner
neple (adv): no amount
nespe (adv): no reason
to (pp): (gen) of
apo (pp): (abl) from; (acc) moving away from
ans (pp): (gen) without
do (pp): (dat) to; (acc) until, moving until you reach, hasta; (gen) for the benefit of
en (pp): (loc) in; (acc) inwards, into
sem (pp): (ins) with
ana (pp): (loc) on; (acc) up (up the stream), along (along the road); (acc) during, along (e.g. along the last few days)
uper (pp): (loc) on, above, over
upo (pp): (loc) under
ud (pp): (loc) outside
peri (pp): (ins) around; (acc) going around; (gen) about, topic, concerning
anti (pp): (loc) in front of; (acc) towards, in the direction of; (gen) before (time)
posti (pp): (loc) behind; (acc) backwards, in the opposite direction of; (gen) after (time)
epi (pp): (loc) at; (ins) near
meθi (pp): (loc) between, in the middle of; (gen) during, in the middle of (time); (ins) surrounded by, among
tras (pp): (acc) through, across (the river), beyond (the mountain)
pra (pp): (gen) next to, on the side of; (acc) moving along (the road, river); (ins) compared to, than
witer (pp): (ins) in agreement with; (abl) according to, según
ar (pp): (acc) because of, thanks to
uta (pp): (dat) for the purpose of, for
pewiter (c): therefore
pe (c): and
we (c): or
nam (c): because of, for
ati (c): but, yet
perti (c): otherwise, if not
tori (c): therefore, then, thus
uti (c): so that, in order that
je (c): if; binary interrogative particle
jeti (c): rather, si no que, instead
nu (c): so, now
som (c): like, just like
posom (c): in a manner that, such that, in a manner such that
aspe (c): for, because
nepos (pn): nothing
witwepe (c): even though, although
poteros (pn): which
φos (pn): how many
aljos (pn): other ** this is an adj
somos (pn): same ** this is an adj
newitwos (pn): not all, some
plus (pn): many
neplus (pn): not many, few
nojnos (pn): not one, none
umilitāt (f): humility
swomīa ekspressjones (f): liberty of expression
abjōn (f): ebb, low tide
annīan (n): stuff, material
adalos (m): filth, urine, liquid manure, mud, mire
aφerōn (m): offspring, descendant, successor
aφlan (n): power, strength, might
agalistrīōn (f): magpie, woodpecker
aφlos (m): hearth
agalajtīan (n): licentiousness
agalajtjos (adj): licentious
agisiθa (f): fear, dread, horror, terror
agitaksīōn (f): lizard
agiθōn (f): harrow
agros (m): flood
axana (f): chaff, awns
axos (n): ear (of grain)
aksla (f): axle, axis
akta (f): consideration, attention
axurnos (m): maple
axwa (f): stream, tributary, riachuelo, small river, brook
ajdīan (n): isthmus
ajdīo (v): to ignite, to set on fire
ajglos (n): shoot, barb
ajgōn (f): property, possessions
ajktēr (m): possessor, owner
ajkilōn (f): acorn
ajkwernōn (m): squirrel
ajlan (n): ash, ashes
ajmos (m): steam, smoke
ajmusjōn (f): ember, hot ash, pyre
ajnakos (m): orphan
ajnīos (m): juniper
ajrōn (f): oar
ajrundīan (n): message, errand
ajrus (m): messenger, servant, herald
ajska (f): demand, question
ajstos (m): kiln
ajstan (n): testicle
ajsōn (f): fireplace
ajtos (m): ulcer
ajtran (n): boil, sore; purulent matter, pus; poison
ajwe (adv): always, forever, for eternity
ajsōn (f): honor, reverence, fear
ajθos (m): oath
alasna (f): awl
Albis (f): river Elbe, of Germany
albitis (f): swan
albis (m): elf, fairy
aldōn (f): canoe, boat
algis (m): elk
alxis (m): shelter, building; temple, sanctuary; settlement, residence
alinōn (f): elbow
alisōn (f): alder
aljanos (adj): zealous, eager; strong, courageous
alkōn (f): auk, a kind of sea bird
alu (n): beer, ale
anslōn (f): blackbird, yellowhammer
ambrīos (m): bucket
būsnis (f): command, order, commandment, precept
anadōn (m): anger
anaφeltos (m): anvil
andurdīan (n): answer, reply
anduros (m): snowshoe
angasos (m): worry, grief, anxiety
angōn (m): spear, dart, hook
angros (m): meadow, lowland
angustjos (adj): narrow, tight
ankula (f): belt, strap, band
ankīōn (f): hip
angos (m): ankle
ankwōn (m): ointment, butter
ansīōn (f): handle
anstis (f): favor, affection
apaldros (m): apple tree
apōn (m): ape, monkey
arbajdis (f): suffering, toil, hardship
arbos (m): working animal, ox
arbīan (n): heritage, inheritance
arbīōn (m): heir
arφōn (m): chickweed
artōn (f): wagtail
arutis (f): ore
arwos (n): scar
asjōn (f): soapstone
askos (m): ash tree
awdos (m): wealth, riches
awris (f): river bank, sand bank at the river’s mouth, delta
awadīa (f): eider
awistran (n): herd, flock
awja (f): island
asanis (f): summer, harvest time, harvest
badjan (n): grave
bajros (m): boar
bajtilos (m): chisel
bakis (f): beach
balwos (adj): sick; bad, evil, wicked; torturous, painful, agonizing
bandis (f): fetter
bangilos (m): a stick, club
bankis (f): bulge
bankōn (m): hill
bansos (m): crib, cradle; barn; stall (for animals)
barnan (n): child
barsos (m): perch
barugos (m): castrated boar
barwos (m): pine, pinetree, conifer
bastos (m): rope, fiber
bawgos (m): ring, bracelet, collar, crown
bellōn (f): bell
bermōn (m): yeast
besamōn (m): broom
bewdos (m): table
bewsan (n): beer
bikja (f): pickaxe
bikkilos (m): a die, dice
biliθjan (n): picture, image, likeness; pattern; example
biljan (n): spike, nail
birilōn (m): barrel
bladan (n): leaf, sheet; blade
blasōn (f): candle, torch
blēdrōn (f): bladder
blēstus (m): blast; gust of wind, burst of wind; breeze
blīwan (n): color, hue
blīθus (adj): joyful, happy, pleasant, pleasing, delightful
blōstran (n): sacrifice
blukkan (n): block, log
braksmōn (f): bream
braktos (m): cracking, snapping, crash
braktumos (m): noise
brajdos (adj): wide
brandos (m): sword
brawdan (n): fragment, piece
brēdōn (m): flesh, meat
bremusis (f): gadfly, horsefly
brestus (m): impairment, handicap
brēθis (f): odor, smell
brigdilos (m): strap, rein, bridle
brinkos (m): edge (of land), brink
brīwos (m): porridge
brōkis (f): leggings, pants, trousers
banōn (m): murderer, killer, slayer
brugjōn (f): bridge
brukis (f): breach, fissure, breaking
brunθis (f): being in heat, being horny
brunθjos (adj): in heat, horny
brunnōn (m): source, wellspring, fountain
bruθan (n): broth
būdilos (m): pouch, bag
buktis (f): bay (body of water)
būkos (m): belly, abdomen
bulgīa (f): wave
bullōn (m): round object, ball, bowl
būla (f): boil, sore
bulstros (m): pillow, cushion
būlōn (f): tumor, cancer
bundan (n): bundle
būros (m): room, chamber
burdan (n): board, plank, table
burstis (f): bristle
buskos (m): bush, thicket
dajgos (adj): soft, malleable
dalja (f): valley
dalkos (m): knife, dagger
dammos (m): dam
danja (f): a flat area, floor
danka (f): pit, hollow
dara (f): injury, damage, harm
dawga (f): shade, shadow
dawos (m): moisture, dew
dēxōn (f): jackdaw
denaros (m): palm of the hand, sole of the foot
digulos (m): pot, melting pot, crucible
dīkos (m): pool, puddle
dīkīan (n): dike, trench, ditch
dōkos (m): cloth, rag
drabos (n): dregs, sediment
drunkis (m): potion
drawgos (m): apparition, ghost, delusion
drugan (n): dream
drēnus (m): wasp, hornet, drone
drupōn (m): drop (of liquid)
dūbōn (f): pigeon, dove
dudran (n): egg yolk
dudros (m): dodder
dukkōn (f): muscle
dulgos (m): debt
duljan (n): tube, pipe; nozzle, spout
dultis (f): celebration, festival
dunga (f): dung, manure, fertilizer
dungīōn (f): vault, treasury, subterranean chamber, underground cellar
dwergos (m): dwarf
egalos (m): leech
ēlos (m): eel
elxos (m): elk
elmos (m): elm, elm tree, elm wood
majtīōn (f): ant
erbōn (m): wolverine
erθōbasjan (n): strawberry
etunos (adj): fat, glutton
etōn (f): manger
φaksan (n): mane
φajgjos (adj): fey, doomed to die, about to die
φajmos (m): foam
φajmīa (f): young woman, maiden, virgin, maid
φalga (f): fallow
φalisos (m): cliff
φarnos (m): fern
φatan (n): vessel, container
φelga (f): felly, outer rim of a wheel
φeltos (n): felt
φergunjan (n): forested mountain
φēra (f): danger
φerθus (m): inlet, fjord
φersna (f): heel
φiφaldōn (f): butterfly, moth
φimbulos (m): giant, monster
φinkōn (m): finch
φinna (f): flipper, fin
φirstis (m): summit, peak; post, ridge of a roof
φitrīan (n): wing
φlaksan (n): flax
φlajnos (m): point
φlaskōn (f): bottle, flask
φlawmos (m): stream, current, eddy
φlewgōn (f): fly, flying insect
φlunθrīōn (f): flatfish, flounder
φlutōn (m): raft, boat, ship
φōdran (n): food, nourishment
φruskos (m): frog
φrustos (m): frost
φullan (n): cup, beaker
φunkōn (m): spark
φurna (f): trout
φursos (m): waterfall, torrent
gagulos (m): sweetwillow, gale, myrtle
gajla (f): gap; gap, chasm, ravine, crevice
galdran (n): incantation, enchantment, spell
galgōn (m): cross
galla (m): gall, bile
galmos (m): echo
galφōn (m): glove
garba (f): sheaf
garnan (n): yarn
garwa (f): yarrow
gasaljos (m): friend, comrade, mate
gatan (n): hole, opening, passage
gawkos (m): cuckoo
gerda (f): girdle
glajmis (f): glass
glēsōn (m): amber, resin
glōdis (f): glow, heat
graptus (m): carving, digging
grewtan (n): grit
grindis (f): fence
grinda (f): gravel, sand, pebbles
xabukos (m): hawk
xaglos (m): hail (the precipitation)
xajna (f): whetstone
xajstros (m): young tree
xajθis (f): heath, wasteland
xakulos (m): coat
xaltra (f): harness, halter
xalmos (m): hay, straw
xalōn (m): tail
xamaros (m): hammer
xamiθīan (n): shirt
xamma (f): shinbone; the hollow of the knee
xanja (f): hen
xanōn (m): rooster, cock
xarmōn (m): ermine, weasel
xasalos (m): hazel
xasōn (m): hare
xexlōn (f): hoarfrost
xēringos (m): herring
xerutos (m): deer, stag
xerθran (n): innards, guts, internal organs
xankōn (m): back of the neck
xumpōn (m): knot
xuntis (m): nut
xōφos (m): hoof
xrawnos (m): raven
xrajgrōn (m): heron
xramusōn (m): ramson, wild garlic, onjon
xrēkan (n): saliva, snot
xrēta (f): honeycomb
xrīdrōn (f): sieve
xrīman (n): soot
xrinθos (n): horned beast
xrīsan (n): twig, sprig, bush
xriθis (m): fever
xrīθa (f): seizure
xrunnos (m): spawn (eggs) of frogs or fish
xrusōn (f): crust
xūbis (f): beehive
xulisa (f): case, covering, shell, pod
xūōn (m): owl
xwajan (n): whey
xwalos (m): whale
xwana (f): angelica (plant)
xwelpos (m): whelp, pup, puppy
xweros (m): kettle
xwīlo (m): to rest
ibaxis (m): ivy
igilos (m): hedgehog
īxwos (m): yew
jago (v): to hunt
jekulos (m): icicle
justos (m): cheese
kanipos (m): little hairs on the chin or cheek; whiskers
kebrōn (m): beetle
kelθos (n): baby, infant, fetus
kīmōn (m): sprout
kisilos (m): pebble; kernel of sand; grain of sand
kisnos (m): pine, spruce
klajwos (m): clover
klajōn (m): clay
klawa (f): claw
kīmbos (m): pincers
kradōn (m): basket; craddle
kulamajsōn (f): coal tit (bird)
kūlōn (f): bump, hole (in the road)
kussos (m): kiss
kussomi (v): to kiss
kwerna (f): millstone, handmill, quern
lajkan (n): game, sport
lajstos (m): track, trace, footprint
lajwarikōn (f): lark
landīn (f): waist, loin
lapilos (m): spoon
lawgis (m): flame, blaze
lawga (f): soap
lawkos (m): leek
lektran (n): afterbirth, placenta
lewskōn (m): groin
lewōn (m): scythe, sickle
linda (f): linden tree
lingwan (n): heather
līθu (n): cider; strong drink; liquor
luksos (m): lynx
lukilos (m): key
madarōn (f): madder
majskan (n): mixture, mash
majsōn (f): titmouse, chickadee
majwos (m): gull, seagull
malmos (m): sand; ore
marikis (m): celery
mariswīnan (n): mereswine, porpoise, dolphin
marθros (m): marten
marōn (f): nightmare
mattukos (m): mattock, ploughshare
maθōn (m): maggot
medūrtis (f): meadowsweet
mēlan (n): time for eating, meal, dinner
melwan (n): ground corn, wheat; flour
mikstilos (m): basil, mistletoe
mōxōn (m): poppy, poppyseed
mūlan (n): muzzle
mulda (f): soil, dirt
muniwa (f): minnow
murxōn (f): carrot, parsnip
musan (n): moss, bog
nabjan (n): beak
nabōgajsos (m): auger
naktagalōn (f): nightingale
nasjan (n): foothill
naskis (m): skin
nastila (f): headband
natilōn (f): nettle
natjan (n): net
naudis (f): trouble, distress
nawstan (n): ship-shed, boathouse
nawtan (n): benefit; profit
nasīnis (f): health
nasīnjos (adj): healthy
nēdis (f): that which is sown; seam, stitch
newdos (m): desire, aspiration; drive, urge, striving
nēθla (f): needle
nidwa (f): a sinking, going down, downfall
nīθan (n): hate, envy, malice
ōφeros (m): shore, coast
paddōn (f): toad
pajda (f): cloak, tunic, shirt, coat
pīkos (m): pickaxe
plaggan (n): a piece of cloth, fabric; patch
plakja (f): spot, stain
plegōn (m): exercise, game
pliktis (f): care, concern; duty, responsibility; carefulness, attention
prattus (m): boastful talk; deceit, trickery, stratagem, list, cunning
prewnos (m): knitting needle
pūkōn (m): hunchback; goblin, spook
rajsa (f): ride; journey
rama (f): frame, prop, support
rasta (f): rest
ratta (m): rat
rawbos (m): rape, pillage, robbery
rawmos (m): cream
rebōn (f): ivy, vine
rēdislīan (n): riddle
remos (n): peace, quiet, tranquility
rēswa (f): counsel, deliberation
ruskīa (f): reed, rush (plant)
rustos (m): rust
sadulos (m): saddle
saga (f): saw (tool)
sagōn (f): story
sajdos (m): magic, charm
sajlan (n): rope, cord
salan (n): hall, room
salba (f): salve, ointment
salxōn (m): willow, sallow
sapan (n): juice, sap
sarwan (n): equipment, armor
segos (n): feast, celebration, party
seglan (n): sail
selxos (m): seal (animal)
sēlus (adj): happy, fortunate; kind, good
seklos (m): seat, chair
sewksla (f): addiction, obsession
sidus (m): custom, habit, practice; conduct
siktrōn (f): drain, sewer, gutter
sindros (m): metal slag, metal dross
askaptos (m): shaft
askagīan (n): stem (of a ship)
askajdila (f): crown
askajθis (f): sheath
askakulos (m): link in a chain, chain link
askalja (f): shell
askawnos (adj): beautiful, shining
askeldus (m): shield
askinkōn (m): thigh, shank
askōxos (m): shoe
askōgos (m): forest
askrawda (f): piece, shred
askuφla (f): shovel
askuldis (f): fault, guilt, blame
askula (f): debt, obligation
askurdis (f): cutting, shearing
askurtīōn (f): skirt
asmeltos (m): smelt (fish)
asmerilos (m): merlin
asneggōn (m): snail
asnidan (n): cutting, slice, piece
asnūtos (m): snout
asnōda (f): rope, string
asnuttus (m): nasal mucus, snot
sōtan (n): soot
sōθan (n): satisfaction
aspalus (m): splinter
aspanga (f): brooch, clasp
asparwos (m): sparrow
aspellan (n): news, message
aspiktos (m): woodpecker
aspewtos (m): spear
aspikan (n): bacon
aspilan (n): dance
aspinnila (f): spindle
aspinθrōn (m): spider
aspīrōn (f): top, peak, summit
aspōdis (f): rush, hurry
aspōlōn (f): spool, reel
aspurōn (m): spur
astaggīos (m): stag
astajgris (m): scaffold, platform; stairs (in plural), step (of stairs, in singular)
astakōn (m): stake
astigōn (f): slope, ramp
astimbos (n): firmness, firmament
astōdan (n): herd of horses
astrajkos (m): line
astrampos (m): stem, stalk
astranda (f): edge, rim
astrawan (n): straw (for animals)
astrīdos (m): battle, fight
astubbos (m): stump, stub
asturis (m): turmoil, confusion, noise
asturjōn (m): sturgeon
asturkos (m): stork
suktis (m): sickness
sūlis (m): column, pillar
sumblan (n): banquet
sultīa (f): saltwater, brine
sumpos (m): fungus; mushroom
sundan (n): strait
surga (f): worry; sorrow
swalwōn (f): swallow (bird)
swanos (m): swan
swardis (f): oath
swarmos (m): dizziness
sweblos (m): sulphur, sulfur
swegla (f): flute
sūltis (m): starvation, death, hunger, famine
tajsila (f): thistle, teasel
takkōn (m): spike, thorn
tangis (f): tongs, pliers
tappōn (m): plug
targōn (f): edge, rim, border
tawan (n): tool
teldan (n): tent, drape
terwan (n): tar
tewnan (n): destruction, ruin, damage
tībran (n): victim
tigulōn (f): tile, brick
tiktis (f): accusation, crime, charge
trugos (m): trough (for animals)
trūθos (m): showman, actor, buffoon, jester, clown
tugilos (m): rein (on a horse)
tundran (n): tinder
turnos (adj): bitter
twīφlos (m): doubt
twisilan (n): fork, bifurcation
unnos (m): oven, furnace
ullustus (m): apathy, lack of desire
unwitōn (m): fool, idiot, moron
urtis (f): garden
utros (m): otter
usgōlja (f): pride, arrogance
uslagan (n): fate, destiny
wabjan (n): web, something woven
wadan (n): shallow water, ford
wagjos (m): wedge
waksan (n): wax
waktwa (f): watch, vigil
wajdan (n): woad
wajgos (m): wall (of a building)
wajθa (f): hunt, persuit, chase
wakwa (f): polynya
walos (adj): wounded
walda (f): dyer’s rocket
wandus (f): mole (animal), vole
wardus (m): guard
wargatrewan (n): gallows
wargos (m): outlaw, criminal
wargiθa (f): curse, doom, condemnation
warjos (m): inhabitant, citizen
warkis (m): pain
wartōn (f): wart
wedran (n): weather
wēgiθa (f): lenience, leniency, mercy
wēnis (f): hope, expectation, belief
werdus (m): host
wermōdos (m): wormwood
wīksila (f): sour cherry
wikkōn (m): male witch, warlock, magician, sorcerer, spellcaster, wizard
wimpilos (m): head covering, wimple, veil, scarf
wīnabasjan (n): grape
wirtis (m): beerwort; herb, spice
wisundis (m): wesent, bison
wiθiwindōn (f): bindweed
wōstinja (f): desert; wilderness
randīōn (m): wren
ristus (m): joint (anatomy)
ūnja (f): joy, delight, pleasure, lust
ūndran (n): wonder, miracle
ūrktis (f): deed, act
ūrstis (f): sausage
θaksus (m): badger
θistilos (m): thistle
θrastus (m): thrush
θurskos (m): cod, codfish
ekspressjōn (f): expression
astabiljo (v): to establish
komputa (f): account, cuenta
φalkōn (m): falcon
grammom (n): gram
milligrammom (n): milligram
kilogrammom (n): kilogram
pilosekunda (f): picosecond
nanosekunda (f): nanosecond
mikrosekunda (f): microsecond
millisekunda (f): millisecond
sekunda (f): second
pikometrom (n): picometer
nanometrom (n): nanometer
mikrometrom (n): micrometer
millimetrom (n): millimeter
kentimetrom (n): centimeter
kilometrom (n): kilometer
metrom (n): meter
Gela Wojnīa (f): Cold War
minūta (f): minute
Kabo-Werde (m): Cape Verde
īōn (m): ion
istorīa (f): history
data (f): date
ēlektriskos adros (m): electric field
magnētiskos adros (m): magnetic field
orθograφīa (f): orthography
kurjakom (n): church
monarxa (m): monarch
djabolos (m): devil, diabolos
djaboliskos (adj): diabolic
Θessalonīka (f): Thessaloniki
plan (m): plan
tekniskos (adj): technical
teknika (f): technique
diskiplīna (f): discipline
nātūra (f): nature, natural world
nātūrālus (adj): natural
programman (n): program
programmo (v): to program
programmatōr (m): programmer
programmatiskos (adj): programmatic, pertaining to a program
kino (m): cinema, movie theater
θeātrom (n): theater
θeātriskos (adj): theatrical
armonīa (f): harmony
armoniskos (adj): harmonic
sustēman (n): system
asφajra (f): sphere
asφajriskos (adj): spherical
suppōno (v): to suppose
integrāl (f): integral
parametrom (n): parameter
parametrīo (v): to parametrize
ingenjātōr (m): engineer
aspekjālus (adj): special
generālus (adj): general
generāl (m): general (military)
admirāl (m): admiral
ēlektriskos (adj): electric, electrical
ēlektrikitāt (f): electricity
grawitāt (f): gravity
ūniwersom (n): universe
ūniwersālus (adj): universal
natsista (m): Nazi
natsismom (n): Nazism
natsistiskos (adj): Nazi
Partīta Natsi (f): Nazi party
relātīwos (adj): relative
relātīwitāt (f): relativity
generālis relātīwitāt (f): general relativity
aspekjālis relātīwitāt (f): special relativity
klassis (f): class
klassiskos (adj): classical; pertaining to a class, to class
klassiska mēxanika (f): classical mechanics
opstrūktjōn (f): obstruction
dēstrūktjōn (f): destruction
īnstrūktjōn (f): instruction
dokumentom (n): document
apsolūtos (adj): absolute
prōduktom (n): product
kwantom (n): quantum (physics)
mēxanika (f): mechanics
kwantiska mēxanika (adj): quantum mechanics
īnstitūtom (n): institute
Siniska Tūtiska Rēspūblika (f): People’s Republic of China
sūkoφanta (m): sycophant
askotsja (m): scotch
magīa (f): magic, sorcery, wizardry
magos (m): magician, wizard, sorcerer
magiskos (adj): magical, pertaining to magic or wizardry
templom (n): temple
prōlētārjos (m): proletarian
prōlētārjātos (m): proletariat
burgēnsis (m): bourgeois
burgesīa (f): bourgeoisie
prosθesis (f): prosthesis
prosθetiskos (adj): prosthetic, artificial
sjampān (m): champagne
sidra (f): cider
wiski (m): whiskey
rōm (m): rum
kentrom (n): center
kentrālus (adj): central
urakān (m): hurricane
kuklos (m): cycle, wheel, circle
kukliskos (adj): cyclical, cyclic, circular
Jerūsalēm (f): Jerusalem
Babulōn (f): Babylon
asxola (f): school
asxolārus (adj): scholar
arxīwom (n): archive
aspjōn (m): spy
aspīo (v): to spy
aspjōnīa (f): esponage
awtomatom (n): automaton
robot (m): robot
robotika (f): robotics
robotiskos (adj): robotic
Tūtiska Swomīetra Armāta (f): People’s Liberation Army
turannos (m): tyrant
turannīa (f): tyranny
turanniskos (adj): tyrannical
rewolūtjōn (f): revolution
rewolūtjonārjos (adj): revolutionary
ēwolūtjōn (f): evolution
ēwolūtjōnārjos (adj): evolutionary
φilosoφīa (f): philosophy
φilosoφos (m): philosopher
φilosoφiskos (adj): philosophical
angelos (m): angel
angeliskos (adj): angelic
seraφīm (m): seraph, seraphim
Pletīa Tjananmen (f): Tiananmen Square
Ruθra Pletīa (f): Red Square
tsjurro (m): churro
arxajos (adj): archaic, ancient, old
arxaīa (f): antiquity
distriktos (m): district
garnisōn (f): garrison
Danu Nīlos (n): Nile River
Danu Mississippi (n): Mississippi River
Prota Medeniska Wojnīa (f): First World War
Tiberis (m): Tiber
Sānktos Kits pe Newis (m): Saint Kitts and Nevis
Danu Tiberis (n): Tiber River
Bosnīa pe Ertsegowīna (f): Bosnia and Herzegovina
Medis Wojnīa (f): the Great War
Witera Medeniska Wojnīa (f): Second World War
Medis Patrīakiska Wojnīa (f): the Great Patriotic War
Nūa Jork (f): New York
Nūa Jersi (f): New Jersey
Nūa Sēland (f): New Zealand
Porto-Riko (m): Puerto Rico
portorikiskos (adj): Puerto Rican
Sānktos Jōānna (m): San Juan, Saint John
Sānktos Petersburg (m): Saint Petersburg
Rōssiska Φederatjōn (f): Russian Federation
Semjuktās Polītīās Amerikas (f): United States of America
Semjuktis Sowetiskōm Sokjālistiskōm Rēspūblikōm (f): Union of Soviet Socialist Republics
Sowetiska Semjuktis (f): Soviet Union
sowetiskos (adj): soviet
rēspūblika (f): republic
φederatjōn (f): federation
rōssiskos (adj): Russian
sokjālistiskos (adj): socialist
sokjālista (m): socialist
partīta (f): party
dēmokratīa (f): democratic
sokjālismom (n): socialism
kommūnistiskos (adj): communist
kommūnista (m): communist
kommūnismom (n): communism
kapitālistiskos (adj): capitalist
kapitālista (m): capitalist
kapitālismom (n): capitalism
polītīa (f): state
Amerika (f): America
Wasinton (f): Washington
Kanada (f): Canada
Mesiko (m): Mexico
Brasilīa (f): Brazil
Parakwarīa (f): Paraguay
Urakwarīa (f): Uruguay
Tsile (m): Chile
Argentīna (f): Argentina
Perūīa (f): Peru
Ajkwātōr (m): Ecuador
Kolumbīa (f): Colombia
Wenetjola (f): Venezuela
Ewrōpa (f): Europe
Rōssīa (f): Russia
Moskowīa (f): Moscow
Sebastopolis (f): Sevastopol
Ukraīna (f): Ukraine
Belorussīa (f): Belarus
Φrankīa (f): France
Parīs (f): Paris
Ljōn (f): Lyons
Polōnīa (f): Poland
Warsowīa (f): Warsaw
Oswentsis (f): Auschwitz
Britannīa (f): Britain
Germānīa (f): Germany
Berlīn (m): Berlin
Ispānīa (f): Spain
Grajkīa (f): Greece
Kōnstantīnopolis (f): Constantinople
Ītalīa (f): Italy
Rōma (f): Rome
Ostarrīxis (f): Austria
Ungārīa (f): Hungary
Ostarrīxungārīa (f): Austriahungary, Austria-Hungary
Serbīa (f): Serbia
Asīa (f): Asia
Japonīa (f): Japan
Sina (f): China
Korīa (f): Korea
Mongolīa (f): Mongolia
Indīa (f): India
Armenīa (f): Armenia
Aserbajān (m): Azerbaijan
Tatsikistān (m): Tajikistan
Kasaxistān (m): Kazakhstan
Grusīa (f): Georgia (country)
Kirgistān (m): Kyrgyzstan
Usbekistān (m): Uzbekistan
Turkmenistān (m): Turkmenistan
Palajstīna (f): Palestine
Isdrāēl (f): Israel
Turkīa (f): Turkey
Āφrika (f): Africa
Arabīa (f): Arabia
Ajguptos (f): Egypt
Estonīa (f): Estonia
Latwīa (f): Latvia
Lītwa (f): Lithuania
bibljoθēka (f): library
diskoθēka (f): discotheque, night club
monarxīa (f): monarchy
monarxista (m): monarchist
māxina (f): machine
Biblja (f): Bible
bibljom (n): book
Kurān (m): Quran, Koran
ōkeanos (m): ocean
positjōn (f): position
askjentīa (f): science
askjentiskos (adj): scientific
φusikos (adj): physical
φusikos (m): physicist
φusika (f): Physics
idea (f): idea
xarta (m): map
papūros (m): paper, papyrus
abussos (m): abyss
komputātrom (n): computer
armāta (f): army
mūsika (f): music
mūsikos (adj): musical
maθēmatika (f): mathematics
maθēmatikos (adj): mathematical
maθēmatikos (m): mathematician
θeōrēman (n): theorem
φōnēman (v): phoneme
φōnētiskos (adj): phonetic
φōnētika (f): phonetics
grammatika (f): grammar
leksikom (n): lexicon
bjologīa (f): biology
xēmīa (f): chemistry
wēlōkitāt (f): velocity
energīa (f): energy
partikula (f): particle
atomos (m): atom
atomiskos (adj): atomic
geōmetrīa (f): geometry
aritmētika (f): arithmetic
trigōnom (n): triangle, trigon
tetragōnom (n): tetragon, quadrilateral
pentagōnom (n): pentagon
Jānwārjos (m): January
Φebrwārjos (m): February
Mārtjos (m): March
Aprīlis (m): April
Mājos (m): May
Jūnjos (m): June
Septembēr (m): September 
Oktōbēr (m): October
Nowembēr (m): November
Dekembēr (m): December
Lūnis (m): Monday
Mārtis (m): Tuesday
Merkuris (m): Wednesday
Jowis (m): Thursday
Weneris (m): Friday
Sāturnis (m): Saturday
Sōlis (m): Sunday
parāta (f): parade
pīrāta (m): pirate
nawta (m): sailor
tekstos (m): text
imperjom (n): empire
Rōmiskom Imperjom (n): Roman Empire
Britanniskom Imperjom (n): British Empire
Germaniskom Imperjom (n): German Empire
Rōssiskom Imperjom (n): Russian Empire
senātos (m): senate
φrasis (f): phrase
φōnologīa (f): phonology
weterānos (m): veteran
φalōn (f): plain, plain field
φanjan (n): fen, marsh, swamp
petalom (n): leaf, petal
septamaka (f): week
jatomi (v): to ride, to go by riding
sodīn (adv): today
sēmidīn (m): midday
sēminoptis (f): midnight
ne (adv): negatory particle; no, not
somajeri (adv): already, so soon
perīomi (v): to pass
werjo (v): to believe, to be convinced of
detūktom (n): evangelium, evangelion, gospel, good message
doīa (f): target, destination; direction
pedanosto (v): to read; to learn
antiwītso (v): to foresee; to guess; to divinate
anawītso (v): to envy
anawītsinnos (adj): enviable
anawītsentos (adj): envious, envying
θjesi (adv): yesterday
ajeri (adv): early, in the morning
peruti (adv): last year
sēmi (adv): half, partially
sēmis (f): half
wis (adv): again
nu (adv): now
neφesatos (adj): cloudy
epastao (v): to represent
epastaetēr (m): representative
epastaetis (f): representation
perajto (v): to maintain, to hold on to, to keep
walpjos (adj): wolf-like
tramjo (v): (+ acc) to play an instrument; (+ acc) to play a role in a story or theatrical play
embīwīo (v): to bring to life, to bring back to life, to revive, to animate
apolūdo (v): to lose something, someone; to lose a battle, a game, or something
nepostjos (adj): neverending, eternal
jomīa (f): quantity, amount
oniskos (adj): northern
soniskos (adj): southern
wesiskos (adj): western
awsiskos (adj): eastern
palja (f): city
pratēr (m): traveller, hiker
lesus (adj): bad
abōl (m): fruit, apple
abolφeros (adj): fruit-bearing, pomiferous
adetis (f): control
upadetis (f): subordination
upadetīo (v): to subordinate
nupadetīo (v): to be insubordinate, to rebel
nupadetīetis (f): rebellion
nupadetīakos (m): rebel
ado (v): to lead, to drive, to guide, to command, to control
adetēr (m): leader, commander
adetrīa (f): leadership
adros (m): field
ajatos (adj): metallic
ajgīa (f): sickness, illness
ajgos (adj): sick, ill
ajos (n): copper
ajtomi (v): to possess, to own, to have
pajtomi (v): to repossess, to reacquire
ajtos (n): spear, pike
alo (v): to nourish, to feed
alutu (n): beer
alφos (adj): white
ammōn (m): stone
ammonatos (adj): stony, hard
amφatos (adj): slithering
amφis (m): snake
amφros (m): rain
an (n): air
anatis (f): duck
anemos (m): breath
anθus (adj): narrow, tight
anjos (adj): old
ankatos (adj): sharp, cutting
ankos (n): angle
annos (m): lamb
anomi (v): to breathe
antān (m): ancestor, predecessor, forefather
apoteletis (f): uncovering, discovery, finding, revelation, apocalypse
apotelo (v): to uncover, to discover, to find, to reveal
antis (f): breath
antiman (n): commencement, start, beginning
antīo (v): to begin, to commence, to start (transitive)
antjos (m): front, forehead
antūktēr (m): prophet
apos (adj): liquid
aposomi (v): to be absent, to be away, to be distant
apostis (f): absence, scarcity
aposwepomi (v): to send away, discharge, dismiss, release, let go, throw away, discard, get rid of, shred, give up
apotelo (v): to open
apoxeφo (v): to take off, to take away, to remove
apsis (f): axe
aris (f): nut
arkaros (m): lock, safe, castle, fortified building, fort
arkomi (v): to lock
aro (v): to plough
arotrom (n): instrument for ploughing
arpu (n): bow and arrow, arc, bow
artiskos (adj): northern, related to bears
artos (m): bear
arxeman (n): beginning, start
asgēn (m): breast, teat
askando (v): to leap
askapos (n): tool
askeljo (v): to owe, to must, to ought
askīdomi (v): to cut
askorpjōn (m): scorpion
asmeka (f): chin
asmeru (n): grease
asmīo (v): to laugh
asneo (v): to laugh
asnīφos (m): snow
asnomi (v): to swim
asnūan (n): sinew, tendon
asnūθos (n): mist
asnusa (f): daughter-in-law
aspekjertis (f): appearance
aspekjo (v): to look at, to regard
aspergos (m): sparrow
aspēs (f): prosperity, luck
aspēso (v): to prosper, to be lucky
asplenθos (n): spleen
aspotus (m): lord, master, sir
aspūo (v): to spit
astao (v): to stand
apastao (v): to remain
antistao (v): to stand against, to resist
perastao (v): to persevere
perastaetis (f): perseverance
perastaetēr (m): persevering person
astego (v): to cover
astēr (m): star
asteφo (v): to stiffen
astis (f): essence, being
astīgo (v): to puncture, to pierce
astīxo (v): to climb
astrenxo (v): to twine
astreφo (v): to gulp, to swallow
astroφo (v): to sip, to suck
astrūjos (adj): easy, facile
astrūo (v): to flow
astūo (v): to hit
atus (adj): sharp
awa (f): grandmother
awgo (v): to enlarge
awgomi (v): to glance
awis (f): bird
awomi (v): to help
awos (m): grandfather
awsōs (f): dawn, morning
awse (adv): tomorrow
axos (n): distress, fear
bao (v): come
baθetos (adj): sunken
baθo (v): to sink
bakom (n): staff
bastēr (m): walker
bastīo (v): to cause to walk
basto (v): to walk
belīa (f): force, strength
ubbelīa (f): effort, endeavor, the amount of work put into something
belisos (adj): stronger, more powerful, comparative of belos
belos (adj): powerful, strong
belφa (f): womb
bena (f): woman
benomi (v): to step, to take a step
bentom (n): floor, ground
beretis (f): praise, glory
bero (v): to praise, to glorify
berjos (adj): praiseworthy, commendable
beru (n): spear
bīwo (v): to live
bīwos (m): life
bīwos (adj): alive, living
blūomi (v): to call
bomastao (v): to stand firmly
bomos (adj): strong, firm, steady
breθus (adj): short, brief
bruθomi (v): to bite
brus (adj): heavy
būo (v): to kiss
bus (m): cattle, cow
galo (v): to call out
galus (adj): naked
gangomi (v): to mock
gelos (adj): cold
gelna (f): snowstorm, blizzard
geris (f): crane (bird)
gerφetis (f): scripture, writing, handwriting, text
gerφetos (adj): written, writing, letter
gerφo (v): to write
glaga (f): milk
glexo (v): divertir, to amuse
groφos (m): crab
gruppos (m): group
dajawēr (m): brother-in-law
dalexos (adj): long
danθwa (f): tongue
danomi (v): to be acquainted with, conocer
danosto (v): to recognize
danu (n): river
datru (n): tear in the eye
datrūo (v): to cry, to shed tears
deksis (f): right (direction)
demetos (adj): tamed, domesticated
demo (v): to tame, domesticate
deniskos (adj): related, familiar, consanguineal
denomi (v): to beget, to produce, to give birth; to create, to make, to produce
denos (n): race, lineage, type, kind, family
dentis (f): genesis, birth, creation, production; birth, generation (as in family tree)
sendentis (f): kinship; family
denus (m): cheek
deo (v): to bind
despotus (m): master of the house
detos (adj): good, beautiful, lovely, morally good, of good quality, proper
dētos (adj): bound together
deφa (f): jaw
dīn (m): day
dīksa (f): justice
dīksjo (v): to judge
dīksjotēr (m): judge, one who judges
dīksomi (v): to point out
dīwos (m): god
djus (m): sky, heaven
do (v): to give
dobasto (v): to arrive (by foot), to walk towards
dōm (m): household, house
domφos (m): number
domφīo (v): to count; to calculate; to reckon
dono (v): to give
donom (n): gift
detodonomi (v): to thank
detodontis (f): thankfulness, gratitude
donos (m): offspring
dontus (m): tooth
donu (n): knee
doru (n): wood, tree; (plural) woods, forest
dranom (n): grain, bread
dranakos (m): baker
drao (v): to run
dremo (v): to sleep
dūketis (f): movement
dūko (v): to lead, to move, to drive, to cause to move, to push
dūjos (adj): beautiful
dūīa (f): beauty
dūs (f): forearm
dusis (f): failure, error, mistake; sin
dūstus (m): taste
dwibrus (m): balance, scale, libra
dwikos (adj): twin, pair
dwojomi (v): to fear
dwojtos (adj): feared
edomi (v): to eat
eθus (adj): sharp
ellūkīo (v): to illuminate
ellekjo (v): to put in, to insert, to place, to collocate
ellūkos (adj): enlightened (mind), wise
ellūφos (adj): sweet, caring, loving
embasto (v): to walk in, to enter
embīwos (adj): alive, living
embos (n): gland
emplūtos (adj): valioso, important
enθūmos (adj): hot
enkasnos (adj): evil
enkretos (adj): talented, clever, able
enkrūos (adj): cold, cool
enswadīa (f): sugar
enswennjos (adj): sleepy, tired, fatigued, exhausted
entīomi (v): to live in, to habitate
entītis (f): habitation, residence, settlement
entorpos (adj): happy
entrūdo (v): to impress (press in)
enudros (adj): wet, watery, liquid
enwardīa (f): energy
enwardjos (adj): energetic, active
epipertīo (v): to bring close, to bring near, to draw close, to draw near
epipertus (adj): close, near
epiteletos (adj): closed
epitelo (v): to close
ēr (m): goat
esan (n): flowing blood, live blood
ettis (f): food
etwos (m): horse, stallion
etwakos (m): horseman, knight, cavalier
θalomi (v): to blossom
θāns (f): goose
θaφīomi (v): to perish, to die
θaφītos (adj): dead
θeba (f): fat (grasa)
θejo (v): to suck
θelo (v): to shine
θeo (v): to put
θēr (m): hedgehog
θersīa (f): courage
θersos (adj): courageous
θēs (m): god, deity
θetis (f): act, deed, feat; fact; behavior
θetos (adj): made, done, finished
θeφetos (adj): burnt
θeφo (v): to burn
θīθetis (f): shape, form, nature, quality; nature, natural world
θīθetiskos (adj): natural
θīθo (v): to mold, to shape, to fashion
θīōm (f): winter
θo (v): to do, to make, to cause
θorsos (adj): proud
θorsīa (f): pride
θortos (m): enclosure
θrīo (v): to defecate
θrūxo (v): to trick, to deceive
θubros (adj): deep
θugatēr (f): daughter
θūlo (v): to pour
θūmatos (adj): foggy, smoky, unclear
θūmos (m): smoke
θūo (v): to run
θutomi (v): to invoke
θūxomi (v): to work
θwerjos (adj): wild
θweropeplos (m): wheel of the animals, zodiac, wheel of the zodiac
θweros (m): wild animal, beast, animal
θweso (v): to breathe
θwōr (m): door
īomi (v): to go
anīomi (v): to find
isus (m): arrow
jadakos (m): priest
jadīo (v): to make holy
jados (adj): holy, saint
jedos (n): ice
jepan (n): liver
jēr (m): year
jesomi (v): to boil
jestos (adj): boiled
jeφo (v): to copulate, to fuck
jugom (n): yoke
jugomi (v): to join, to tie together
jugos (n): team
jūenīa (f): youth
jūenus (adj): young
kajkos (adj): blind
kakka (f): excrement, poop, dung
kalos (adj): handsome
kanīa (f): song
kano (v): to sing
kantis (f): corner
kapjo (v): to grasp, to capture, to understand
kapros (m): goat
kapu (n): head
kapinos (adj): main, chief, principal, head
kasnos (adj): black, dark, dusky, obscure
kāt (m): puppy, cub
kedom (n): smoke
kelatos (adj): sticky
kela (f): glue
kenga (f): hook
kenkom (n): kneecap
kerpo (v): to pluck
klena (f): maple
klepetos (adj): stolen
klepo (v): to steal
klīo (v): to lean
klūetos (adj): clean, cleaned
klūnis (f): buttocks, hip, gluteus
klūo (v): to clean
klūomi (v): to hear, to listen
kobis (f): success
kobjos (adj): successful
kotus (m): fight, dispute, argument
kotwīo (v): to fight, to dispute, to argue
kremom (n): onion
kretos (adj): intelligent, insightful, clever
krīomi (v): to separate
kruan (n): dead blood, raw blood
krūos (adj): raw
lāks (m): salmon
lamφros (adj): lightweight
lasus (adj): eager
latos (n): swamp
lawetos (adj): washed, clean, cleaned
lawo (v): to wash
lawomi (v): to acquire
lebis (f): lip
lekjo (v): to lay down, to put, to place
upolekjo (v): to place under, to put under; to submit, to subdue, to make subject
lekjos (m): place
leksetrīennos (adj): armed, equipped
leksetrīo (v): to arm, to equip, to weaponize
leksetrom (n): weapon, arms
lekso (v): to protect, defend
lenθos (n): kidney
lenos (adj): slow
lenxo (v): to float
leōn (m): lion
līgomi (v): to jump
līgos (adj): quick, fast, rapid
līdomi (v): to bind
līθomi (v): to lick
līmōn (m): lake
linemos (adj): dirty
linepomi (v): to leave
linos (n): flax, linen, cloak, cloth
līpetos (adj): moistened, moist
līpo (v): to moisten
līsos (adj): straight
līttos (adj): bound together
lokus (m): lake
lūdo (v): to break
lūθa (f): person
luθomi (v): to arrive
lūkīeman (n): illumination, lights
lūkīo (v): to illuminate
lūkos (m): light
lūttos (adj): broken
lūφetis (f): love, affection
lūφo (v): to love
lūφos (m): love
lūxetis (f): lie, falsehood, false claim
luxetjos (adj): false, incorrect
lūxo (v): to lie, to tell a lie, to speak falsely
makos (n): pouch
mānis (f): moon
manu (n): human, person, mankind, humanity
maran (n): hand
matēr (f): mother
medenīa (f): world
medeniskos (adj): worldly, concerning the world
medisos (adj): bigger, greater
medomi (v): to consider
medus (adj): big, great
meθjos (m): middle
meldomi (v): to milk; to masturbate
melθos (m): lightning
melitatos (adj): viscous
melitu (n): honey
menθetis (f): knowledge, studies, science
menθetiskos (adj): scientific
menθo (v): (active) to teach, to instruct; (passive) to learn, to study
menomi (v): to think; to remember, to recall
mentis (f): thought; memory, remembrance
mēns (m): month
mensos (n): meat
meromi (v): to die
mertis (f): death
mertos (adj): dead
mesgomi (v): to sink
mīθetis (f): urine
mīθo (v): to urinate
mīktis (f): a blink, blink of an eye, moment, instant
mīos (adj): small
mīsos (adj): smaller
mīxomi (v): to blink
moktis (f): power, ability
mōn (m): neck
moru (n): sea
mosxos (m): brain
moxīa (f): power, ability
moxomi (v): to be able, poder
moxos (adj): able, powerful
moxjos (adj): possible
moxje (adv): possibly, maybe, perhaps
nemoxjos (adj): impossible
nemoxje (adv): impossible
nemoxje (int): impossible!
mūkos (adj): mute, dumb, foreign, barbarian, unclear, unintelligible
mūs (m): mouse
nasis (f): nose
naspekjennos (adj): unseen, invisible
nastrūīa (f): difficulty, hardship
nastrūjos (adj): hard, difficult
nawis (f): boat, ship
neθennos (adj): unfinished, undone, not finished, not done
nejados (adj): not holy, cursed
nemerintos (adj): immortal, undying
nemos (n): sacrifice, worship, sacred place, place of worship
nepom (n): thing
nepōtis (f): granddaughter
nepōtus (m): grandson
nēr (m): power, force, vital energy
nerūptos (adj): unbroken, unbreakable
netomi (v): to attain, to reach
netus (adj): dead
neφatos (adj): cloudy, misty, foggy, unclear
neφos (n): cloud
neφros (m): kidney
neφummenjos (adj): bottomless, without bound, boundless, unfathomable, abyss, abysmal
nexa (f): fingernail
nisdos (m): nest
noman (n): name
noptis (f): night
noφilos (m): navel
numan (n): breath, soul, spirit
dalexonumanjos (adj): long-suffering, patient, long-passioned
nūīa (f): newness, novelty, news (in plural)
nūos (adj): new
ojnomi (v): to join together, to join, to unite
ojntos (adj): joined, united
oju (n): lifetime
olos (n): elbow
ombāl (m): charcoal
omban (n): butter, fat
ombanatos (adj): buttery, greasy, oily, fatty
ombetos (adj): annointed
ombo (v): to anoint
omos (n): back, espalda, shoulder
omos (adj): bitter
onkatos (adj): bent, not straight
onkos (m): bend, turn
onos (n): load, burden; trial, difficult experience; temptation
ōpis (f): eye
orōn (m): eagle
orφos (m): servant, slave
osdos (m): branch
ōs (f): mouth
ostu (n): bone
otratos (adj): sharp, acute
otris (f): corner
owis (f): sheep, ram, ewe
ōwos (n): ear
pakko (v): to duck
pao (v): to protect, to look after, to care for, to save
paetēr (m): protector, savior
paetis (f): protection, savation
pasomi (v): to cough
pastīa (f): question
pasto (v): to interrogate, to question
pastro (v): to sneeze
patēr (m): father
patrīa (f): fatherland, motherland
patrīakiskos (adj): patriotic, concerning the fatherland or motherland
sempatrīakos (m): compatriot
pawan (n): fire
pawanatos (adj): fiery, burning
pedomi (v): to tread
pegan (n): breast
pela (f): skin
peltomi (v): to fold
pelatos (adj): floury, dusty
pelis (f): flour
pentos (m): road
peplatos (adj): circular, round
peplos (m): wheel, circle
peraskīdomi (v): to pierce, to cut through
perbasto (v): to walk through, to penetrate
perdomi (v): to fart
perθetos (adj): finished
perθo (v): to finish
permenomi (v): to think through, to brainstorm, to think intensely
perpontōm (m): transcurso, time
perreφomi (v): to equip, to furnish, to arrange, to prepare
persatos (adj): dusty, dirty
persom (n): dust
perta (f): rib
perūkomi (v): to announce, to send a message, to report
perūktēr (m): messenger, reporter, announcer
perūktis (f): message, report, announcement, letter
pesus (m): penis
petan (n): feather
peto (v): to take away
petomi (v): to fly
petos (adj): cooked
pettis (f): fate
pettiskos (adj): fateful
petu (n): livestock
pīdos (adj): inactive, reluctant, lazy
pīeman (n): payment, wage
piman (n): peace, tranquility, rest
pīo (v): to pay
pipetis (f): drink, refreshment
pipo (v): to drink
pisda (f): vulva
pistis (f): fish
pjeīa (f): quietness, silence
pjeos (adj): quiet
plako (v): to punch, to strike, to hit
plenos (adj): full
pletīa (f): flat expanse, area; area (geometry); square, plaza
pletus (adj): flat, broad
pletis (f): flat, plane (geographical feature); plane (geometry)
plōtus (m): flood
plūmōn (m): lung
plusis (f): flea
plūtos (adj): rich
po (v): to cook
podis (f): foot
pontōm (m): track, path, road, way
pontōmanīter (m): pathfinder
portos (m): pig
postiman (n): end, finish; goal; purpose
postīo (v): to finish, to end (transitive)
potīa (f): mastery
potinīa (f): sovereignty; state (geopolitical)
potiniskos (adj): national, having to do with the state
potinos (adj): sovereign
potus (m): master
prepos (n): body
pretīpos (m): face
uperpretīpos (m): surface
pretis (f): prayer
preto (v): to pray, to ask
prinomi (v): to buy
prena (f): whore, slut, prostitute
prīomi (v): to like
prīa (f): happiness
prīos (adj): happy
prūkomi (v): to preach, proclaim, declare, announce
prūktēr (adj): proclaimer, preacher, declarer, announcer
prūo (v): to jump
prūsetos (adj): frozen
prūso (v): to freeze
pūdis (f): pain
pūdjos (adj): painful
pula (f): hair
rādis (f): root
rādiskos (adj): fundamental, elementary, basic
rapa (f): turnip
rebīa (f): darkness
rebos (adj): dark
redīa (f): kingdom
redjo (v): to rule
rēdus (m): king, ruler
repomi (v): to snatch
reptom (n): building, edifice
reφomi (v): to build, to construct, to erect
rodīa (f): law; right, rights
rodīgerφetis (f): orthography
rodīredus (m): judge
rodos (adj): straight, correct, appropriate, true
roduktīa (f): grammar
ros (adj): sharp
rūgomi (v): to vomit
ruθros (adj): red
rūktom (n): vomit
rūpomi (v): to break
rūptos (adj): broken
sagjan (n): flag, banner
sagjamφeros (adj): flag-bearing
sagjeman (n): sign, mark, letter, symbol, meaning, significance
sagjo (v): to give a sign, to signify, to mean
sagomi (v): to seek, to search
sāl (m): salt
sālatos (adj): salty
sawsīa (f): thirst, dryness
sawsos (adj): dry
sedo (v): to wait
sedomi (v): to sit
sellekjo (v): to put together, to assemble, to build
selpa (f): butter
selpatos (adj): buttery, oily, greasy
sema (f): summer
semado (v): to conduct, to lead
seman (n): seed
sembasto (v): to walk together, to march
sembomo (v): to confirm
semjugomi (v): to unite, to join together
semjuktis (f): union
semjuktos (adj): united, joined
semφeθjo (v): to compete
semφero (v): to bring together, to cause to congregate
semφertis (f): congregation
semφettis (f): competition
sendetis (f): surrendering, sacrifice (not in the religious context), giving up, price (metaphorical and literal)
sendo (v): to surrender, to give something up
senkotwo (v): to fight, to dispute
senkotus (m): fight, dispute
senos (adj): old
sentis (f): feeling
sentomi (v): to feel (in both emotional and perceptory senses)
sentrūdo (v): to compress
seo (v): to sow
sepomi (v): to follow
serpo (v): to creep, crawl, move slowly, slink
sesta (f): hour, time
sexomi (v): to hold
sexetis (f): (geometry) volume
sīo (v): to sift
sisdo (v): to sit down (transitive)
sjūo (v): to sew
soman (n): being, essence
somi (v): to be
somos (adj): same, alike
aljos (adj): other
alnos (adj): different
alnīa (f): difference
somūkomi (v): to say the same thing as, to agree with, to be in accordance with
sosteo (v): to need
sostja (f): need
sostjos (adj): necessary, needed, essential, fundamental
sotan (n): dung, excrement
sowan (n): sun
sūnus (m): son
suros (adj): sour
swadīa (f): sweetness
swadus (adj): sweet
swadutērjos (adj): kind-hearted, sweet-hearted, merciful, kind
swelomi (v): to burn
swemīa (f): loneliness, solitude
swemīntos (adj): desolating
swemīo (v): to cause to be alone, to desolate
swemjos (adj): alone
swennos (m): sleep, slumber
swepo (v): to sleep
swepomi (v): to throw, send away, send
swerxos (adj): ill, sick
swesōr (f): sister
swetura (f): mother-in-law
sweturos (m): father-in-law
swīdomi (v): to sweat
swīo (v): to whistle
swomīo (v): to liberate, to set free
swomīetēr (m): liberator
swomīa (f): freedom, liberty
swomos (adj): free, libre
tadetos (adj): hated
tado (v): to hate
tadomi (v): to fall
tastom (n): tomb, grave
tastuka (f): collection of tombs, graves, catacombs
tago (v): to touch
tarketos (adj): twisted
tarko (v): to twist
tarnos (adj): sharp
tasus (adj): grey
tatis (f): battle, war
tawetos (adj): molten
tawo (v): to melt
tawros (m): bull, bison
tegus (adj): thick
teletīa (f): hideout, escondite
teletis (f): secret
telīa (f): warmth
telo (v): to cover, to hide
telus (adj): warm
tengomi (v): to think
tenktis (f): thought
tenomi (v): to extend, to stretch, to spread
tentena (f): country, expanse
tenus (adj): thin
tepos (n): heat, warmth
terman (n): boundary, end
ternatos (adj): sharp
ternokapros (m): horned goat
ternom (n): horn
tero (v): to cross over
tersīa (f): thirst
tersus (adj): thirsty
tēru (n): heart
terus (adj): sterile
tīno (v): to lie, to settle
tīomi (v): to settle, to populate, to dwell
tolomi (v): to hold up, to lift
tona (f): shell
tonos (m): string, chord, fiber
torpīa (f): happiness, satisfaction, joy, pleasure
torpos (adj): satisfied, pleased, happy
torsos (adj): dry
traomi (v): to mix
traso (v): to run
trebom (n): dwelling
tremo (v): to tremble, to shake
tristus (adj): in a bad mood
trūdo (v): to press
tūsjo (v): to spy
tūta (f): tribe, people
tūtiskos (adj): popular
tuφom (n): shoulder
twenos (adj): holy
twōn (m): dog
ubbastīa (f): exodus, walking out, exit, leaving
ubbasto (v): to walk out, to exit, leave
udros (adj): wet
udroφeros (m): water bearer
udūkomi (v): to admit, to confess, to let out (a secret)
udwōpo (v): to shout, to yell, to cry out
udwōpetis (f): outcry, shouting, yelling
ūjom (n): egg
ūkomi (v): to say
uksēn (m): ox
ūktis (f): speech, phrase, saying, proverb, maxim
ummenomi (v): to forget
ūomi (v): to dress
uperallenxo (v): to hang (transitive)
upertolomi (v): to sustain, to hold over, to support
uprajos (adj): superior, supreme
upraīa (f): superiority, supremacy
upojos (adj): inferior
upoīa (f): inferiority
upertoltis (f): a sustain, a support
uperūkomi (v): to yell, to scream
uperφūjo (v): to grow up, to rise
upūkomi (v): to whisper
upūktos (adj): whispered, secret
ūsomi (v): to burn
ūstos (adj): burnt
waθomi (v): to go
walena (f): wool
walīa (f): hunger
waljos (adj): hungry
walpos (m): wolf
wapos (adj): bad, evil
wardjentos (adj): working, diligent, hardworking, hard working
wardjo (v): to work
warmis (f): worm
watomi (v): to fill
wattis (f): journey
wedos (adj): wet
weθo (v): to transport
weleo (v): to wish, to want, to desire
welētis (f): wish, desire, will
welja (f): wish, desire, want, will
welnjos (adj): desired, cherished, dear; dear, expensive
welpo (v): to hope
welpetis (f): hope
wepo (v): to speak
werdom (n): work
werθom (n): word
werman (n): time
weros (adj): true
werus (adj): broad
wesgeros (m): sunset, evening
wesomi (v): to wear
westis (f): clothing, vestimenta
wetos (n): season
weφetos (adj): woven
weφo (v): to weave
peweφomi (v): to boast, to brag
weφomi (v): to praise
wīdīa (f): wisdom
wīdomi (v): to know, saber
wīdos (adj): wise
wiθwa (f): widow
wīktēr (m): victor
wīkomi (v): to be victorious over, vencer
wīktos (adj): beaten, loser of the battle
wīmos (adj): twisty
winθa (f): elm
wīnom (n): wine
wiros (m): man
wīsomi (v): to sprout
wīspotus (m): village chief, landlord, lord
wisūkomi (v): to retell, to tell a story, to narrate
wisūktis (f): narration, story, history
wītis (f): village
wītos (adj): bright
wītso (v): to see
φelowītsetis (f): clairvoyance
φelowītsetēr (m): clairvoyant
wīttis (f): wisdom, knowledge
witwodinjos (adj): daily
wodan (n): water
wantos (m): wind
wōpis (f): voice
wōpakos (m): spokesperson, portavoz
wōpo (v): to call, to name (+instrumental)
wōr (m): raven
wortomi (v): to turn (transitive)
wortis (f): time, vez, instance; turn
wosan (n): spring (season)
wojos (m): soldier
wojnīa (f): war
φagetis (f): division, army division, section
φagetos (adj): divided
φago (v): to divide
φadis (f): beech
φados (adj): good
φaθa (f): leg
φao (v): to shine
φāp (f): bean
φarθa (f): beard
φarīa (f): heat, warmth
φaros (adj): warm, hot
φarsis (f): barley
φeθjo (v): to request, to ask for
φeθomi (v): to dig
tastoφeθakos (m): gravedigger
φelos (adj): bright, clear; clear, not fogged; clear, obvious
φenθus (adj): thick
φenomi (v): to strike down, to kill, to slay
φentos (adj): murdered, killed
φerθo (v): to protect
φerθontus (adj): high, tall
φerjos (adj): hot, warm
φero (v): to carry
φeretrom (n): bucket; carrier; container
φeφrus (m): beaver
φīa (f): bee
φīdomi (v): to split, to separate
φīθetis (f): trust, faith
φīθetos (adj): trusted
φīθo (v): to trust, to be confident in
φīttos (adj): separated, split
φleo (v): to cry
φlīdeman (n): lights
φlīdo (v): to be shining
φlomo (v): to flower, to blossom
φlotatos (adj): flowery, colorful
φlotos (m): flower
φogetos (adj): baked, roasted
φogo (v): to bake, roast
φōr (m): thief
φoratos (adj): thievous
φratēr (m): brother
φrūan (n): well, spring, source, fountain
φrūomi (v): to begin, to start
φrujs (f): eyebrow
φrūtis (f): beginning, start
φugo (v): to escape, to flee, to run away
φūdo (v): to hit, to strike
φūθos (adj): awake, aware
φūjo (v): to grow, to become
φummēn (m): bottom
φūomi (v): to become
φūxetos (adj): bent
φūxo (v): to bend
xajdos (m): young goat
xedo (v): to find, to hold
xeθōm (m): earth
xelo (v): to call
xeφo (v): to take, to accept; to receive
xlūo (v): to joke
xrenθom (n): beam (structure)
xreman (n): herb, plant
xreo (v): to grow (of plants)
xostiskos (adj): foreign
xostus (m): stranger
armis (f): arm
menu (n): palm of the hand
awθār (f): udder
pogu (n): lap
orθom (n): testicle
orsu (n): arse, ass, butt, anus
pesna (f): heel
netros (m): corpse
rūsman (n): throat
θerna (f): bowels
otēr (m): intestine
dūsomi (v): to taste
θersa (f): horror
xūros (m): fear
agos (n): fault, sin
agesīo (v): to sin
agestēr (m): sinner
ajmos (n): copy, image
ajwa (f): vital force
menos (n): mind
dwimenesjos (adj): double-minded
kroska (f): leg
galōs (m): brother's wife, sister's husband
jenatrōs (m): brother-in-law's wife, sister-in-law's husband
telpa (f): space, expanse
osan (n): autumn
teweros (m): north wind, northwind
gradis (f): hail
tonār (m): thunder
tondrena (f): storm
ajtis (f): part
solos (adj): whole, in totality
bera (f): mount, mountain, hill
beruka (f): mountain range
lenθa (f): steppe
aθeros (m): ocean
θerxan (n): thorn
θastom (n): stick
betu (n): resin
ajtu (n): oak
apsa (f): aspen
φeredom (n): birch
θelna (f): pine
talan (n): reed
termus (m): cherry
kojna (f): grass
koslos (n): hazel
morom (n): blackberry
ogu (n): berry
olom (n): alder
morwis (f): ant
wopsa (f): wasp
mua (f): fly
lua (f): louse
parmis (f): grub
ambis (f): eel
torom (n): crow
trosdos (m): thrush
tetēr (m): grouse
eperos (m): boar
xelu (n): tortoise
lūks (m): lynx
ūr (f): squirrel
wāl (m): fox
meθu (n): mead
kār (f): wax
rūman (n): cream
φaris (f): spelt
pūr (f): wheat
ruxjos (m): rye
awida (f): oat
tikēr (f): pea
adis (f): cereal
beru (n): millstone
φerθom (n): fort
φru (n): bridge
lūθis (f): people
jewis (f): law
petu (n): wealth
misθos (m): fee
wesnos (m): price; worth, value
korom (n): war
wīktis (f): victory
bentis (f): step, the act of walking
deneman (n): offspring, seed, descendants
denetis (f): birth, production
denetōr (m): one who begets, produces, parent
dotis (f): the act of giving
dotōr (m): giver
klūos (n): fame
nūomi (v): to renew
nesomi (v): to meet
φlena (f): bubble, ball, sphere
φleo (v): to blow
weo (v): to cause to swell
sarpru (n): silver
sjersu (n): iron, rust
xultan (n): gold
krosgan (n): lead (metal)
drantom (n): mercury
astantom (n): tin
brūko (v): to use, to make use of, to employ, use, comsume
kasto (v): to throw, to cast, to hurl, to fling
abalagjo (v): to put away, to stow away, guardar, to set aside
annīo (v): to perform, to execute
ago (v): to fear, to be afraid, to be afraid of
agiso (v): to frighten, to terrify
agjo (v): to harrow
aglīo (v): to damage; to offend
ajktro (v): to beg
ajkīo (v): to irritate, annoy, bother
ajlīo (v): to kindle
ajso (v): to rush
ajstīo (v): to respect
ajwīo (v): to graze
ajsīo (v): to honor
